+++++++++++++++++++++++++++++++++++++++++++++++++++++++++++++++++++++++++++++++++
+B  +     +       +               +     +               +             +   +   + +
+ +++ + +++ +++ +++ +++++++++++ +++ +++ + +++ +++++++++ + +++++ +++++ + + + + + +
+     + +     + +   + +       +       + + +   +     +   + +     +   + + +   +   +
+++++++ + +++++ + +++ + +++++ +++++++++ + + +++ +++ +++ +++ +++++ + + + +++++++ +
+       + + +   +   + + +   + +         + +   + + +   +   +       + +   + +     +
+ +++++++ + + +++++ + + +++ + + +++++++ + +++ + + +++ +++ +++++++++ +++++ + +++++
+       + + +       + +   +     + +     + + +       + + +   +   +   +     + +   +
+ +++++ + + +++++++++ +++ +++++++ + +++++ + +++++++++ + +++ + + + +++ + + + + + +
+     + + +         +   +   + +   + +   + +     +   + +   +   + +   + + + + + + +
+++++ + + + +++ +++ +++ +++ + + + + +++ + + + +++ + + + +++++++ +++ + + +++ +++ +
+ +   +   + + + +       +   + + + +     + + +   + +   + +   +   +   + +   +     +
+ + +++++++ + + +++++++++ +++ + + +++++ + +++++ + +++++ + + + +++ +++ +++ +++++ +
+ + +         + +         +     +     + +     + +   + +   +   +   + +   +       +
+ + + +++++++++ + +++++++ +++++++ + +++ +++++ + +++ + + +++++++++ + +++ +++++++++
+ + +   +   +   + +       +     + +       +   +   + + +   +       +     +     + +
+ + +++++ + + + + +++++++++ +++ +++++++++ + +++ +++ + +++ +++ +++++ +++++ +++ + +
+   +     + + + +         +   + +       + +   +   + +         +   +     +   + + +
+ +++ +++++ + + +++++++++ +++ + + +++++ +++++ +++ + +++++++++++ + +++++ +++ + + +
+     +       +         +     +       +           +         +   +           +  A+
+++++++++++++++++++++++++++++++++++++++++++++++++++++++++++++++++++++++++++++++++