####################
##       ##    ### #
## #####    ##     #
#             ###  #
##### ######      ##
#####     ## #### ##
##### ### ##       B
##### ### ## #######
A     ###    #######
####################